11111111111111111111111111111111
11111111111111111111111111111111
22222222222222222222222222222222
22222222222222222222222222222222
22222222222222222222222222222222
22222222222222222222222222222222
22222333222222333222222223332222
22222222222222222222222222222222
22222222222222222222222222222222
22222222222222222222222222222222
22222222222222222222222222222222
11111111111111111111111111111111
11111111111111111111111111111111
22222222222222222222222222222222
22222222222222222222222222222222
22222222222222222222222222222222
22222222222222222222222222222222
22222333222222223332222222223332
22222222222222222222222222222222
22222222222222222222222222222222
22222222222222222222222222222222
22222222222222222222222222222222
11111111111111111111111111111111
11111111111111111111111111111111

